W W W W W W W W W W W W W W W W W W W W W W W W W
W B S S S 1 S S S S S S S S S S S S S 3 S S S B W
W S W W W W S W W W W W W W W W W W E W W W W S W
W S W S S S S S S S S S S S S S S S S S S S W S W
W S W S W W S W W W E W W W E W W W S W W S W S W
W S W S W 2 S S S S S W W W E S S S S 4 W S W S W
W S S S S S W W S W E E E E E W E W W S S S S S W
W S W S W S S S S W W W W W W W E E S S W S W S W
W S W S W W S W W W W W W W W W W W S W W S W S W
W S W S S S S S S S S S S S S S S S S S S S W S W
W S W W W W S W W W W W W W W W W W E W W W W S W
W B S S S S P S S S S S S S S S S S S S S S S B W
W W W W W W W W W W W W W W W W W W W W W W W W W