W W W W W W W W W W W W W W W W W W W W W W W W W
W B S S S S S S S S S S S S S S S S S S S S S B W
W S W W W W S W W W W W W W W W W W W S W W W S W
W S W S S S S 3 S S S S S S S S S S S S S S W S W
W S W S W W S W W W W E E W W W W W S W W S W S W
W S W S W S S S S S S E W W E S S S S S W S W S W
W S S S S S W W S S W 1 E 2 W S W W S S S S S S W
W S W S W S S S S S W W W W W S S S S S W S W S W
W S W S W W S W W W W W W W W W W W S W W S W 4 W
W S W S S S S S S S S S S S S S S S S S S S W S W
W S W W W W S W W W W W W W W W W W W S W W W S W
W B S S S S P S S S S S S S S S S S S S S S S B W
W W W W W W W W W W W W W W W W W W W W W W W W W